1111111111111
1000000000E01
10P0000000001
1000000C00000
1000000000001
1111111111111