111111111111
100000E00C01
100P0000000
100000000001
111111111111