1111111111
1000000001
10P0000E01
1000000001
1111111111