1111111111111
10E000100C001
10P0000000001
1000000100C01
1111111111111