11111111111111111111
10P000000001C000E001
10000001000001000001
10000100000001010101
11110000101000000001
1C0001000C0100000001
1000000010001C000001
11111111111111111111