11111111111111111111111
1P000000000000001000001
10001000100C10010010001
10100000011100000000001
10000000000000001001001
10000000111110000000001
11110000100C01000010001
10000001000001010010001
1C010000000001000100E01
11111111111111111111111