11111111111111111111111111111111111111111
1000000P000010C00010000000000E10C00000011
10001000000000010010111001010010000000011
10000000000100000010010001111110101101011
10100000000000000011010000001000000000011
10100010C00000100011000000001001111111011
10000000000000000010011110001001000000011
10C01000000001000010010001000000000000011
11111100111111111111111111111001111111111
10000000000000000010000000000000000000011
10100111100100100010011111111111111110011
101001CC100100100010010000000000000010011
10100100100100100010010111111111111010011
1C100100100100100000010100000000001010011
101001001001001000000101C0000000101010011
10100100100100100010010111111111101010011
101001001001CC100010010000000000001010011
10100100100111100010011111111111111010011
10000000000000000010000000000000000000011
11111111111111111111111111111111111111111